111111111111111111111
1C0000CCCC000000000C1
1000101000000001C0011
1P001E100000000CCCC01
11111111111111111111