111111111
1000000E1
1C00000C1
1P0000C11
111111111